F F F F F F F F F F F 
F F F F F E F F F F F 
F F F S F F F N F F F 
F F E F F F F F F F F 
F N F F F F F F F S F 
F F F F F F F F F F F 
F F F F F P F F F F F 
F S F F F F F F F N F 
F F F F F F F F F F F 
F F F F F F F F F F F 
F N F E F F E F N F F 
F F F F F F F F F F F  
F F F F S F F F F F F 
F F F F F F F F F F F 
F F F F F F F F F F F 
